##################
##############..##
#.              ##
#.              ##
##  ##########  ##
##  #........#  ##
##  #........#  ##
##  #           ##
##  #           ##
##  ##############
##               #
##               #
##..##############
##################
16 3
6 2
6 3
10 2
10 3
14 2
14 3
3 4
2 4
3 8
2 8
8 6
10 7
11 7
13 6
14 8
15 8
12 10
12 11
8 10
8 11
4 10
4 11
