########
###.####
##  ####
##     #
#.   .##
#### ###
####.###
########
6 4
3 3
4 3
5 4
3 5
