###################
#####   ###########
#####   ###########
#####   ###########
###      ##########
### # ## ##########
#   # ## #####  ..#
#               ..#
##### ### # ##  ..#
#####     #########
###################
11 2
2 3
5 3
5 6
5 8
7 6
7 7
